[
{
"LVL":1,
"ID":1,
"MAP":
[
"M","N","N","N","W","W","W","W","W","W","W","W","W","W","W",
"W","N","W","N","W","W","W","W","W","W","W","W","W","W","W",
"W","N","W","N","N","N","N","W","W","W","W","W","W","W","W",
"W","N","W","N","W","W","N","W","W","W","W","W","W","W","W",
"W","N","N","N","N","N","W","N","W","W","W","W","N","N","N",
"W","N","W","W","W","W","W","N","N","N","N","N","N","W","N",
"W","N","W","W","W","W","W","W","W","W","W","W","W","W","N",
"N","N","N","N","N","N","N","N","N","N","W","W","W","W","N",
"N","W","W","W","W","W","W","W","W","N","W","W","W","W","N",
"N","W","W","W","W","N","N","N","N","N","N","N","N","N","N",
"N","N","N","N","N","N","W","W","W","N","W","W","W","W","W",
"W","N","N","W","W","W","W","W","W","N","N","N","N","N","W",
"N","N","W","W","W","W","W","W","W","W","W","W","W","N","W",
"W","W","W","W","W","W","W","W","W","W","W","W","W","N","W",
"W","W","W","W","W","W","W","W","W","W","W","W","W","N","G"
]
},
{
"LVL":1,
"ID":2,
"MAP":
[
"M","N","N","N","N","N","W","W","W","W","W","W","W","W","W",
"W","W","W","W","W","N","N","N","N","N","N","N","N","N","N",
"W","W","W","W","W","N","W","W","W","W","W","W","W","W","N",
"W","W","W","W","W","N","W","W","W","W","W","W","W","W","N",
"W","W","W","W","W","N","N","W","W","W","W","W","W","W","N",
"W","W","W","W","W","W","N","W","W","W","W","W","W","W","N",
"W","W","W","W","W","W","N","N","N","N","N","N","W","W","N",
"W","W","W","W","W","W","N","W","W","W","W","N","W","W","N",
"W","W","W","W","W","W","N","W","W","W","W","W","N","N","N",
"W","W","W","W","W","W","N","W","W","W","W","W","W","N","W",
"W","W","W","W","W","W","N","N","N","N","W","W","N","N","W",
"W","W","W","W","W","W","N","W","N","N","W","W","N","W","W",
"W","W","W","W","W","W","N","W","W","N","N","N","N","W","W",
"W","W","W","W","W","W","N","W","W","W","N","N","N","W","W",
"G","N","N","N","N","N","N","W","W","W","W","W","W","W","W"
]
}
]